World: 21
0-0:
0000000000000000000000000000000000000000000000000000000000000000000000000000000000000000000000000000000000000000000000000000000000000000000000000000000000000000000000000000000000000000000000000000000000000000000000000000000000000000000000000000000000000000000000000000000000000000000000000000000000000000000000000000000000000000000000000000000B00000000000000000000000000000BA00A000000000000000000000000000A00A000000000000000000000000000A00000000000000000000000000000CA00000000000000000000000000000DCCCC0000000000000000000000000CEEEDDCCCCCCCCC000000000C000000EEEEEEEDEEDDEED0CCCCCCCCECCCCCCDDDDDDDEEEDEDEDCEDDEEEEEEDDDDDE
World: new

0-0:
00000000000000000000000000000000000000000000000000000000000000000000000000000000000000000000000000000000000000000000000000000000000000000000000000000000000000000000000000000000000000000000000000000000000000000000000000000000000000000000000000000000000000000000000000000000000000000000000000BBB00000000000000000000B000000BBBAB000000000000000000BAB000000AAA00000000000000000000A0000000AAA00000000000000000000AC000000AAA00000C0000000000C000ADCCCCCCCCCCCCCCD0000000000D00CCEDEDEDDDEDDDDDDECC00000CCCE00DDDDEEDDDDEDEEEEEDED00000DEED0CDEEDEEDEEDEDDEEDEEDECCCCCDEEDCEEEDDDDDEEDEDEDEEEEEDEDDDEDDDDDDDDDDEDDEEDEDEDDEDEDDDDEDDEEEE
1-0:
0000000000000000000000000000000000000000000000000000000000000000000000000000000000000000000000000000000000000000000000000000000000000000000000000000000000000000000000000000000000000000000000000000000000000000000000000000000000000000000000000000000000000000000000000000000000000000000000000000000000000000000000000000000000000000000000000000000000000B00000000000000000000000000000BAB0000B0000B00000000000C00C0000AB000BAB00BAB0000000000DCCE00CCBAB000A0000A00000000000DDDD0CCDAA0000A0000A00000000000EDDDEDEDCA0000A0000A00000000000DEDDEEEDDA0CCCCCCCCC00000CC0000EDDEEEDDECCEDEEDDEDECCCCCDE0000EEDEDEDEDEDEDDDEEDEEDDDDDDECCCC
World: nand

0-0:
00000000000000000000000000000000000000000000000000000000000000000000000000000000000000000000000000000000000000000000000000000000000000000000000000000000000000000000000000000000000000000000000000000000000000000000000000000000000000000000000000000000000000000000000000000000000000000000000000000000000000000000000000000000000000000000000000000000000000000000000000000000000000000000000000000000000000000000000B00000B0000000000000000000000BBAB000BAB00000000000000000000BABA00000A0000000000000000000000A0A00000A0000000000000000000000A0A00000A0000000000000000CCCC00A0CCCCCCC00CCCCCCCCCCCCCCEDEDCCCCEDEEDEE00EEDDEDEEEDEDEDDDDE
0--1:
CCCCEDEEDEE00EEDDEDEEEDEDEDDDDEDDDDDDDDDDD00DDDDDDDDKKKKKDDDDDDDDDDDIDDDD00DDDDDDDDDKKKDDDDDD0000000000000DDDDDDDDDDDKDDDDDD0000000000000DDDDDDDDDDDDDDDDDDDDDDDDDIDIDDDDDDDDDDDDDDDDDDDDDDDDDDDDDDDDDDDDDDDDDDDDDDDDDDDDDDDDDDDDDDDDDDDDDDDDDDDDDDDDDDDDDDDDDDDDDDDDDDDDDDDDDDDDDDDDDDDDDDDDDDDDDDDDDDKKKIIDDDDDDDDDDDDDDDDDDDDDDDDDDDKKDIIIDDDDDDDDDDDDDDDDDDDDDDDDDDDKKIKDDDDDDDDDDDDDDDDDDDDDDDDDDDDDDIDDDDDDDDDDDDDDDDDDDDDDDDDDDDDDDDDDDDDGDDDDDDDDDDDDDDDDDDDDDDDDDDDDDDGGDDDDDDDDDDDDDDDDDDDDDDDDDDDDDDGJDDDDDDDDDDDDDDDDDDDDDDDDDDDDDDDJJDDDDDDDDDDDDDDDDDDDDDDDDDDDDDDDJDDDDDDDDDDDDDDDDDDDDDDDDDDDDDDDDDDDDDDDDDDDDDDDDDDDDDDDDDD
-1--1:
DDDDDDDDDDDDDDDDDDDDDDDDDDDDDDDDDDDDDDDDKKKDDDDDDDDDDDDDDDDDDDDDDDDDDDDDKKDDDDDDDDDDDDDDDDDDDDDDDDDDDDDKKKDDDDDDDDDDDDDDDD00DDDDDIIDDDDKKDDDDDDDDDDDDDDDD00DDDDDDIIDDDKDDDDDDDDDDDDDDDDDDDDDDDDDDDIDDDDDDDDDDDDDDDDDDDDDDDDDDDDDDIIDDDDDDDDDDDDDDDDDDDDDDDDDDDDDDDDDDDDDDDDDDDDDDDDDDDDDDDDDDDDDDDDDDDDDDDDDDDDDDDDDDDDDDDDDDDDDDDDDDDDDDDDDDDDDDDDDDDDDDDDDDDDDDDDDDDDDDDDDDDDDDDDDDDDDDDDDDDDDDDDDDDDDDDDDDDDDDDDDDDDDDDDDDDDDDDDDDDDDDDDDDDDDDDDDDDDDDIIIIDDDDDDDDDDDDDDDDDDDDDDDDDDDDIDDIDDDDDDDDDDDDDDDDDDDDDDDDDDDIDDDDDDDDDDDDDDDDDDDDDDDDDDDDDDIDDDDDDDDDDDDDDDDDDDDDDDDDDDDDDIDDDDIIIIIDDDDDDDDDDDDDDDDDDDDDDDDDDIDDDDDDDDDDDDDDDDD
